


SO    ./path_to_the_south_texture

F 220   ,                    100, 0
C         225, 30,   0

NO      ./path_to_the_north_texture
WE            ./path_to_the_west_texture

EA                 ./path_to_the_east_texture

11111111111111
11000000111111
11000001111111
11100000000001
10000000W00011
10000000101111
11111111111111

