F 220, 100, 0
C 225, 30, 0

111111
100001
1002001
100011
111111