F 220   ,                    100, 0
C         225, 30,   0

NO ./path_to_the_north_texture
SO ./path_to_the_south_texture
WE ./path_to_the_west_texture
EA ./path_to_the_east_texture

111111111
11000001111
1100N2001111
1110000000000111
1000000000011
100000001011
111111111111




quelque chose