


SO    ./path_to_the_south_texture

F 220   ,                    100, 0
C         225, 30,   0

NO      ./path_to_the_north_texture
WE            ./path_to_the_west_texture

EA                 ./path_to_the_east_texture
000000000000000000000000
111111111111111111111110
111111111110000001111110
111111100110000011111110
111111111110000000000110
1111111111111111W0001110
100000001011111111111110
111111111111111111111110
000000000000000000000000
