F 220, 100, 0
R 1920 1080


C 225, 30, 0


111111
100001
10N2001
100011
111111