


SO    ./path_to_the_south_texture

F 220   ,                    100, 0
C         225, 30,   0

NO      ./path_to_the_north_texture
WE            ./path_to_the_west_texture

EA                 ./path_to_the_east_texture
000000000000000000000000
111111111111111111111110
1111111000000 000001111110
1111111001100000011111110
11111110000000000110
11111110000000000W0001110
100000001011100111111110
111111111111110111111110
000000000000000000000000
