NO content/textures/barrel.xpm
SO content/textures/bluestone.xpm
WE content/textures/redbrick.xpm
EA content/textures/door.xpm
F 275,74, 1


  111
1100011
110E011
 1100011   
 1100011
 1100011
   1111