11111111111
1100000E001
1000P001001
10100000001
11111111111