11111111111
1C00000E001
10C0P001001
1010000P001
1111111111