
11111111111
1C00000E001
10C00001001
1010000P001

11111111111