11111111111
1C00000E001
10C01001001
10100001001
11111111111