11111111111
1C00000E001
10C0P201001
10100000001
11111111111