SO textures/greystone.xpm
WE textures/redbrick.xpm
EA textures/eagle.xpm
S textures/mv.xpm
F 75,74,74
C 1,10,254

  111 111 111 11111111                   
  1000100010001000000001
  1010101010101010000001
  1010101010101010000001
  1010101010101010000001
  1010101010101010000001
  1010101010101010000001
  1010101010101010000001
  1010101010101010000001
  1N10001000100010000001
  1001111111101110110111
 10100000000000000001
10001111111111111111
 1111
